NO maps/textures/base/white_wall.xpm
SO maps/textures/base/grey_wall.xpm
WE maps/textures/base/red_wall.xpm
EA maps/textures/base/brown_wall.xpm

F 220,100,0
C 225,30,0

        1111111111111111111111111
        1000000000110000000000001
        10110000011100000S0000001
        1001000000000000000000001
111111111011000001110000000000001
100000000011000001110111111111111
11110111111111011100000010001
11110111111111011101010010001
11000000110101011100000000001
100000000N0000001100000010001
10000000000000000001010010001
110000011101010111110111100111
11110111 1111111 111111110001
11111111 1111111 111111111111