NO maps/textures/base/white_wall.xpm
SO maps/textures/base/grey_wall.xpm
WE maps/textures/base/red_wall.xpm
EA maps/textures/base/brown_wall.xpm

F 220,100,000
C 225,030,000

111111
100101
100101
1100N1
111000